0000000000000000000
000P000000000000000
0000000000000000000
0000010000010000000
0000011000110000000
0000010101010000000
0000010010010000000
0000010000010000000
0000000000000000000
0000000000000000000
0000000000000000000