0000000000000000000
000P000000000000000
0000000000000000000
0000011111110000000
0000011000110000000
0000010101010001000
0000010010010001000
0000010000010001000
0000000000000001000
0000000000000000000
0000000000000000000